5_89_6_42
_97_341_5
__42_7__3
3715_9_24
__21_____
_6_7__351
__5392_1_
___6__279
_26_71__8
