4_6__8_2_
529____73
3_1_27654
2354_91__
6185_2__9
7__186___
_____3518
8__76149_
_____5367
