4 _ 6 _ _ 8 _ 2 _
5 2 9 _ _ _ _ 7 3
3 _ 1 _ 2 7 6 5 4
2 3 5 4 _ 9 1 _ _
6 1 8 5 _ 2 _ _ 9
7 _ _ 1 8 6 _ _ _
_ _ _ _ _ 3 5 1 8
8 _ _ 7 6 1 4 9 _
_ _ _ _ _ 5 3 6 7
